{
    "SCAN":
    {
        "45": "98102",
        "44": "98101",
        "46": "98103",
        "47": "98104",
        "48": "98105",
        "49": "98106",
        "50": "98107",
        "51": "98108",
        "52": "98109",
        "53": "98112",
        "54": "98115",
        "55": "98116",
        "56": "98117",
        "57": "98118",
        "58": "98119",
        "59": "98121",
        "60": "98122",
        "61": "98125",
        "62": "98126",
        "63": "98133",
        "64": "98134",
        "65": "98136",
        "66": "98144",
        "67": "98146",
        "69": "98154",
        "70": "98155",
        "71": "98164",
        "75": "98177",
        "76": "98178",
        "78": "98195",
        "80": "98199",
        "4": "98004",
        "5": "98005",
        "6": "98006",
        "7": "98007",
        "8": "98008",
        "21": "98033",
        "22": "98034",
        "25": "98039",
        "26": "98040",
        "33": "98056",
        "36": "98059",
        "10": "98011",
        "17": "98028",
        "1": "98001",
        "2": "98002",
        "3": "98003",
        "15": "98023",
        "18": "98030",
        "19": "98031",
        "20": "98032",
        "28": "98042",
        "31": "98047",
        "32": "98055",
        "34": "98057",
        "35": "98058",
        "68": "98148",
        "72": "98166",
        "73": "98168",
        "77": "98188",
        "79": "98198",
        "81": "98010",
        "82": "98022",
        "83": "98038",
        "84": "98045",
        "85": "98051",
        "86": "98065",
        "87": "98027",
        "88": "98029",
        "89": "98052",
        "90": "98074",
        "91": "98075",
        "92": "98092",
        "93": "98070",
        "94": "98014",
        "95": "98077",
        "96": "98053",
        "97": "98024",
        "98": "98072",
        "100": "98902",
        "101": "98908",
        "102": "98901",
        "103": "98944",
        "104": "98942",
        "105": "98930",
        "106": "98903",
        "107": "98951",
        "108": "98948",
        "109": "98953",
        "110": "98936",
        "111": "98932",
        "112": "98935",
        "113": "98937",
        "114": "98947",
        "115": "98952",
        "116": "98938",
        "117": "98923",
        "118": "98933",
        "119": "98921",
        "120": "98939",
        "121": "98409",
        "122": "98406",
        "123": "98404",
        "124": "98402",
        "125": "98411",
        "126": "98413",
        "127": "98419",
        "128": "98418",
        "129": "98415",
        "130": "98401",
        "131": "98405",
        "132": "98416",
        "133": "98417",
        "134": "98403",
        "135": "98388",
        "136": "98466",
        "137": "98303",
        "138": "98351",
        "139": "98464",
        "140": "98465",
        "141": "98333",
        "142": "98349",
        "143": "98407",
        "144": "98335",
        "145": "98394",
        "146": "98395",
        "147": "98528",
        "148": "98332",
        "149": "98329",
        "150": "98431",
        "151": "98430",
        "152": "98439",
        "153": "98327",
        "154": "98493",
        "155": "98438",
        "156": "98433",
        "157": "98496",
        "158": "98497",
        "159": "98498",
        "160": "98499",
        "161": "98467",
        "162": "98444",
        "163": "98446",
        "164": "98445",
        "165": "98447",
        "166": "98448",
        "167": "98408",
        "168": "98391",
        "169": "98422",
        "170": "98352",
        "171": "98443",
        "172": "98390",
        "173": "98372",
        "174": "98354",
        "175": "98424",
        "176": "98421",
        "177": "98375",
        "178": "98374",
        "179": "98371",
        "180": "98373",
        "181": "98580",
        "182": "98387",
        "183": "98397",
        "184": "98330",
        "185": "98398",
        "186": "98304",
        "187": "98348",
        "188": "98558",
        "189": "98328",
        "190": "98344",
        "191": "98338",
        "192": "98323",
        "193": "98396",
        "194": "98360",
        "195": "98385",
        "196": "98321",
        "197": "98019",
        "198": "98012",
        "199": "98020",
        "200": "98021",
        "201": "98026",
        "202": "98036",
        "203": "98037",
        "204": "98043",
        "205": "98087",
        "206": "98201",
        "207": "98203",
        "208": "98204",
        "209": "98206",
        "210": "98207",
        "211": "98208",
        "212": "98223",
        "213": "98252",
        "214": "98258",
        "215": "98259",
        "216": "98270",
        "217": "98271",
        "218": "98272",
        "219": "98275",
        "220": "98287",
        "221": "98290",
        "222": "98291",
        "223": "98292",
        "224": "98294",
        "225": "98296",
        "226": "98205"
    }
}